00000000000000000000
11001000011100111010
01011110110110101110
01110011100011110100
01011101111100010010
01010100000101111110
01000111011101010100
00111101100101100110
01100010110110110010
01010100100101011010
01111111001110110000
00100010011101111110
01111011010110000010
01001001010001010110
01101010010110111100
00101110111010101011
01100101101110110010
00110001001011011110
01111111100001110100
00000000000000000000
